aria->aria2
ash->dash
awk->gawk
bazaar->bzr
exuberant->ctags
exuberant-ctags->ctags
fab->python-fabric
fabric->python-fabric
gnugrep->grep
gnulibtool->libtool
gnumake->make
gnureadline->readline
gnutar->tar
gpg->gnupg
pgp->gnupg
greadline->readline
hg->mercurial
idn->libidn
libgc->gc
libreadline->readline
memcache->memcached
nodejs->node
pil->python-pil
pillow->python-pillow
pip->python-pip
pkgconfig->pkg-config
png->libpng
pychecker->python-pychecker
pyyaml->python-pyyaml
rdiff->librsync
rdiffbackup->rdiff-backup
rpm->rudix
rustc->rust
ssh->python-ssh
svn->subversion
sqlite3->sqlite
supervisord->supervisor
tiff->libtiff
virtualenv->python-virtualenv
yaml->libyaml
